PPPPPPPPPPFFFFF
PSPPPPPPPPFFGFF
PPSPPPPPPPFFFFF
PPPSPPPPPPPPPPP
PPPPSSSSSSSSSSD
PPPPPSGFFPPPPDP
PSSSPPSPPPPFPDP
PSGFPPPSPPPDPPP
PSSSPPPPSPPPPFF
PPPPPPPPPSPPPPF
PPPPPPPPPPSPPPP
HHHHHHHHHHHSPPP
FFFFFFFFFFFFSPG
PPPPPPPPPPPPPSS
GFHFDSFFHDDDFHA
PPPPPPPPPPPPPPP
