HHHPPHHHHH
HPPPPPFFPH
HFAPPFFFGP
HFFPPFSFPP
HPPDPPFFPH
HDSDPSFFPH
HDDDSSSSSH
HPPPSPPPSH
HSSSSPSGSH
HGHHHSSHHH
PPPPPPPPPP