HHHPPHHHHH
HPPPPPFFPH
HFAPPFFFPP
HFFPPFSFPP
HPPDPPFFPH
HDSDPSFFPH
HDDDSSSSSH
HPPPSPPPSH
HSSSSPSGSH
HHHHHSSHHH
PPPPPPPPPP