PPPPPPPPPPFFFFF
PSPPPPPPPPFFGFF
PPSPPPPPPPFFFFF
PPPSPPPPPPPPPPP
PPPPSSSSSSSSSSD
PPPPPSFFFPPPPDP
PPPPPPSPPPPFPDP
PPPPPPPSPPPDPPP
PPPPPPPPSPPPPFF
PPPPPPPPPSPPPPF
PPPPPPPPPPSPPPP
HHHHHHHHHHHSPPP
FFFFFFFFFFFFSPG
PPPPPPPPPPPPPSS
GFHFDSFFHDDDFHA
PPPPPPPPPPPPPPP